GGGGGGGGGGGGGGGGGGGG
GUUUUUUUUUUUUUUUUUUG
GUUUUUUUUUUUUUUUUUUG
GUUUUUUUUUUUUUUUUUUG
GUUUUUUUUUUUUUUUUUUG
GUUUUUUUUUUUUUUUUUUG
GUUUUUUUUUUUUUUUUUUG
GUUUUUUUGUUUUUUUUUUG
GUUUUUUUUUUUUUUUUUUG
GUUUUUUUUUUUUUUUUUUG
GUUUUUUUGUUUUUUUUUUG
GUUUUUUUUUUUUUUUUUUG
GUUUUUUUUUUUUUUUUUUG
GUUUUUUUUUUUUUUUUUUG
GUUUUUUUUUUUUUUUUUUG
GUUUUUUUUUUUUUUUUUUG
GGGGGGGGGGGGGGGGGGGG